1 1 1 1 1 1 1 1 1 1 1 1 1 1 1 1 1 1 1 0 1 1 1 0 1 1 1 1 1 1 1 1 1 1 1 1 1 1 1 1 1
1 2 1 4 0 0 1 0 0 0 0 0 1 6 1 0 0 0 1 0 1 6 1 0 1 6 1 6 1 0 0 6 1 0 0 0 0 0 0 0 1
1 0 1 1 1 8 1 0 1 1 1 1 1 0 1 0 1 0 1 0 1 0 1 0 1 0 1 0 1 0 1 1 1 0 1 1 1 0 1 0 1
1 0 0 0 0 0 0 0 0 0 0 0 1 0 0 0 1 0 1 0 1 0 1 0 0 0 0 0 1 0 0 0 1 0 1 6 1 0 1 7 1
1 0 1 1 1 1 1 1 1 0 1 0 1 1 1 1 1 0 1 0 1 0 1 0 1 1 1 0 1 0 1 1 1 0 1 0 1 0 1 1 1
1 6 1 0 0 0 0 0 1 0 1 0 1 6 1 0 0 0 0 0 1 0 0 0 1 0 0 0 1 0 0 0 0 0 1 0 0 0 1 0 1
1 1 1 0 1 0 1 1 1 0 1 0 1 0 1 0 1 0 1 0 1 1 1 0 1 1 1 1 1 0 1 0 1 0 1 1 1 0 1 0 1
1 6 0 0 1 6 1 0 0 0 1 0 0 0 1 6 1 6 1 0 1 0 0 0 0 0 0 0 0 0 1 0 1 0 1 0 0 0 0 0 1
1 1 1 0 1 1 1 0 1 1 1 1 1 0 1 1 1 1 1 0 1 1 1 1 1 1 1 0 1 1 1 1 1 0 1 1 1 0 1 1 1
1 6 0 0 0 0 0 0 0 0 0 0 1 6 1 7 1 0 0 0 1 0 0 0 1 0 0 0 0 0 1 0 1 0 0 0 1 0 1 0 1
1 1 1 0 1 0 1 0 1 1 1 0 1 1 1 0 1 1 1 0 1 0 1 0 1 0 1 0 1 1 1 0 1 1 1 1 1 1 1 0 1
1 1 1 0 1 0 1 0 0 0 1 0 0 0 0 0 1 0 1 0 1 0 1 6 1 6 1 0 0 0 1 0 0 0 0 0 0 0 1 0 1
1 1 1 0 1 1 1 1 1 1 1 1 1 1 1 1 1 0 1 0 1 0 1 1 1 1 1 0 1 0 1 1 1 1 1 1 1 0 1 0 1
1 7 8 0 0 0 0 0 0 0 0 0 0 0 0 6 1 0 1 0 1 0 0 0 0 0 9 0 1 0 0 0 1 0 1 0 0 0 0 0 1
1 6 1 1 1 1 1 1 1 1 1 1 1 1 1 1 1 0 1 0 1 1 1 1 1 0 1 0 1 1 1 0 1 0 1 1 1 0 1 1 1
0 0 0 0 0 0 0 0 0 0 0 0 0 0 0 0 0 0 0 0 1 6 0 0 1 0 1 0 1 6 1 0 0 0 0 0 0 0 8 0 0
1 1 1 0 1 0 1 0 1 1 1 1 1 1 1 1 1 1 1 1 1 1 1 0 1 0 1 0 1 0 1 1 1 1 1 1 1 1 1 0 1
1 0 1 6 1 6 1 6 1 0 0 0 0 0 0 0 0 0 0 1 1 3 1 0 0 0 1 0 0 0 0 0 1 0 1 0 1 6 0 0 1
1 0 1 1 1 1 1 1 1 1 1 0 1 1 1 1 1 1 0 0 1 1 1 0 1 1 1 0 1 0 1 1 1 0 1 0 1 1 1 0 1
1 0 0 0 1 0 0 0 0 0 0 0 1 0 0 0 0 0 0 1 1 1 6 0 0 6 1 6 1 6 1 0 0 0 1 0 1 6 0 0 1
1 1 1 1 1 1 1 1 1 1 1 1 1 1 1 1 1 1 1 1 = 1 1 1 1 1 1 1 1 1 1 1 1 1 1 1 1 1 1 1 1
0 0 0 0 1 0 0 0 1 3 1 0 0 0 0 0 1 3 1 1 1 1 7 0 0 0 1 0 0 0 0 6 1 0 0 0 0 0 1 0 0
1 0 1 1 1 1 1 0 1 1 1 1 1 1 1 0 1 1 1 1 1 0 0 0 1 0 1 0 1 1 1 1 1 1 1 1 1 1 1 0 1
1 0 0 0 0 0 0 0 0 0 0 0 0 0 1 6 1 0 1 3 1 6 1 6 1 0 1 0 0 0 1 6 0 0 0 0 0 0 0 0 1
1 0 1 1 1 1 1 0 1 0 1 1 1 1 1 1 1 0 1 1 1 1 1 1 1 0 1 1 1 0 1 1 1 1 1 1 1 0 1 1 1
1 0 1 0 0 0 0 0 1 0 1 6 1 6 1 6 1 0 0 0 1 6 0 0 0 0 0 0 0 0 0 0 1 0 0 0 0 0 0 0 1
1 1 1 0 1 1 1 1 1 1 1 0 1 0 1 0 1 1 1 1 1 1 1 1 1 1 1 1 1 1 1 0 1 0 1 1 1 1 1 0 1
0 0 0 0 0 0 0 0 0 0 0 0 0 0 1 0 0 0 0 0 1 6 1 0 0 0 0 0 0 0 0 0 1 6 1 0 0 0 1 0 0
1 1 1 1 1 1 1 0 1 1 1 0 1 1 1 1 1 0 1 0 1 0 1 0 1 1 1 1 1 1 1 0 1 1 1 0 1 0 1 0 1
1 0 0 0 1 0 1 0 0 0 1 0 0 7 1 0 1 6 1 6 1 0 0 0 1 6 0 0 0 6 1 6 1 6 0 0 1 0 0 0 1
1 0 1 0 1 0 1 1 1 0 1 1 1 1 1 0 1 1 1 1 1 0 1 1 1 1 1 0 1 1 1 1 1 1 1 0 1 1 1 1 1
1 0 1 0 1 0 0 0 0 0 1 0 0 0 0 0 1 0 1 0 1 0 1 6 0 0 1 0 1 0 0 6 1 6 0 0 9 0 0 0 1
1 0 1 0 1 1 1 0 1 0 1 1 1 0 1 0 1 0 1 0 1 0 1 1 1 0 1 0 1 0 1 1 1 1 1 1 1 1 1 0 1
1 7 1 0 1 0 1 0 1 0 1 6 1 0 1 0 1 0 1 0 1 0 0 0 0 0 0 0 0 0 0 0 8 0 1 0 0 5 1 0 1
1 1 1 0 1 0 1 1 1 0 1 0 1 0 1 0 1 0 1 1 1 1 1 1 1 0 1 1 1 0 1 0 1 0 1 0 1 1 1 0 1
0 0 0 0 1 0 0 0 0 0 1 0 0 0 1 0 0 0 1 3 1 6 1 6 0 0 1 0 1 0 1 0 1 0 0 0 1 0 0 0 0
1 1 1 0 1 1 1 0 1 1 1 0 1 1 1 0 1 1 1 1 1 0 1 1 1 1 1 0 1 0 1 0 1 1 1 9 1 1 1 8 1
1 0 0 0 1 0 0 0 0 0 0 0 0 0 1 0 0 0 0 0 1 0 0 0 0 0 1 0 0 0 1 6 1 0 1 0 0 0 1 0 1
1 1 1 0 1 1 1 0 1 0 1 0 1 0 1 1 1 0 1 1 1 1 1 1 1 0 1 9 1 1 1 1 1 0 1 1 1 0 1 0 1
1 6 0 0 0 6 1 6 1 6 1 6 1 0 0 6 1 0 0 0 1 3 1 0 0 0 0 0 0 0 0 0 0 0 0 0 1 3 0 0 1
1 1 1 1 1 1 1 1 1 1 1 1 1 1 1 1 1 1 1 0 1 1 1 0 1 1 1 1 1 1 1 1 1 1 1 1 1 1 1 1 1
