1111111111111111111111111111111111111111111111111111111111111111111111111
1000000000000000000000000000000000000000000000000000000000000000000000001
1000000000000000000000000000000000000000000000000000000000000000000000001
1>00000000000000000000000000000000000000000000000000000000000000000000001
1000000000000000000000000000000000000000000000000000000000000000000000001
1000000000000000000000000000000000000000000000000000000000000000000000001
1111111111111111111111111111111111111111111111111111111111111111111000001
1000000000000000000000000000000000000000000000000000000000000000001000001
1000000000000000000000000000000000000000000000000000000000000000001000001
1000000000000000000000000000000000000000000000000000000000000000001000001
1000000000000000000000000000000000000000000000000000000000000000001000001
1000000000000000000000000000000000000000000000000000000000000000001000001
1000001111111111111111111111111111111111111111111111111111111000001000001
1000001;<<;=<;10100010000100010101000000000000000100001000001000001000001
1000001;==<<1010001000100001110001101110001011111101111011101000001000001
1000001<=;<=1010111110001011010100100011111000000101000000001000001000001
1000001;=<<=1011100011101010010110001000001111001100011011101000001000001
1000001<;<<<1000000000001000000011011011000000000001011000101000001000001
1000001=<<=;1111111111111111111111111111111111111111111110101000001000001
1000001===<=1000000100000000001000010000000100000000001000101000001000001
1000001<=<<<1011111111110111101011110111111101110111111010101000001000001
1000001<;=<=1010101101000001001001000100011101000000001110111000001000001
1000001<<;<;1010101101111101111001110110110001011111101000001000001000001
1000001<<=;=1010100000000100000000000000000101000000101111101000001000001
1000001=<<<<1010001111111111111111111111111111111001101000101000001000001
1000001=;<<<1000001001000000000000000=<0000000001111001010001000001000001
1000001;=;<=1000111111010001111100000111111111101000001011101000001000001
1000001<;<;<1010001001011111100111110111000000101011001000101000001000001
1000001==<<=10100010110110000000100001=<011110101001111010101000001000001
1000001<=<<;1011001010000011100000100001000016101100011010101000001000001
1000001;==<=1000001011001111111111111111111011101001001011111000001000001
1000001<<<==10111110000010;10101010010010610<<<01011101010011000001000001
1000001=<;<<1011001000111011000=01011101011011101001001000111000001000001
1000001=;<<<100101110110100101110000<000061061601011101110011000001000001
1000001;;=<=10110011010011010<0111111010011011101001001000001000001000001
1000001=;=<;1001011000011000010000071011061061601011101010111000001000001
1000001<=<;;10110011100111<1111111111010011011101010101010001000001000001
1000001<=<<;1001101000011000001020131;11061017601110001111011000001000001
1000001<;<<<1011001001111111191000111111011016001100111000001000001000001
1000001<==;<10011010000010071=1100010100061011101000101011011000001000001
1000001;<<<=1000101101011011101000110001011016001011101010011000001000001
1000001=;=<<1001101001001000101010000101061011101000101111011000001000001
1000001=<<<=1100001001001110101111111111111010001010101000001000001000001
1000001;<<;<111110101110100010014<9010=0000010111010101011101000001000001
1000001<;<<<100010101010101111011110001111;010001010101000111000001000001
1000001<=<;<1001101010001010000100101116;11111191011101010001000001000001
1000001==;<<1000101011001000110800000000000000001000101010101000001000001
1000001;<<;=1001101010001111111111111111111111111110111111101000001000001
1000001==<<;1100101000111000010000000100111101000010001000001000001000001
1000001=<<<<1110001100000010110111110110001001111000101011101000001000001
1000001;<=<=100011110010100010015<=00010101100001110101010001000001000001
1000001=<<=;1110001001111100000111110000100110101000111011111000001000001
1000001;;==;1011101100000101100000000111110000100010001000011000001000001
1000001<=;;=1000101111111111111111111111111111111111111111001000001000001
1000001;<<;;1011101100000010000001000000000100000000000001001000001000001
1000001<<=<;1010000101111010111101010101010001010111111100011000001000001
1000001;;=<;1011110101000010100001011111111111110010000111001000001000001
1000001<<<;<1001000111011110110111110100010101011110110101011000001000001
1000001;<<<<1100010000000000100000000001000000000000100000001000001000001
1000001<<<=<1111111111111111111111111111111111111111111111111000001000001
1000001<<<;<1000000000000000000000000000000000000000000000000000001000001
1000001<;<=<1000000000000000000000000000000000000000000000000000001000001
1000001=<;<<1000000000000000000000000000000000000000000000000000001000001
1000001=<;=<1000000000000000000000000000000000000000000000000000001000001
1000001;;;;<=000000000000000000000000000000000000000000000000000001000001
1000001111111111111111111111111111111111111111111111111111111111111000001
1000000000000000000000000000000000000000000000000000000000000000000000001
1000000000000000000000000000000000000000000000000000000000000000000000001
1000000000000000000000000000000000000000000000000000000000000000000000001
1000000000000000000000000000000000000000000000000000000000000000000000001
1000000000000000000000000000000000000000000000000000000000000000000000001
1111111111111111111111111111111111111111111111111111111111111111111111111
