1 1 1 1 1 1 1 5 1 1 1
1 2 0 0 0 0 1 0 1 4 1
1 1 1 0 1 0 1 0 1 0 1
1 5 1 0 1 0 6 0 0 0 1
1 0 1 0 1 1 1 0 1 1 1
1 0 1 4 1 0 1 0 6 0 1
1 0 1 1 1 0 1 0 1 0 1
1 0 0 0 6 0 1 0 1 0 1
1 1 1 0 1 0 1 0 1 1 1
0 0 0 0 0 0 1 0 1 0 0
1 1 1 0 1 6 1 0 1 0 1
1 4 1 0 1 0 0 0 6 0 1
1 6 1 0 1 0 1 1 1 1 1
1 0 0 0 1 0 1 0 6 0 1
1 0 1 1 1 0 1 0 1 1 1
1 0 0 0 6 0 1 0 1 0 1
1 1 1 0 1 1 1 0 1 0 1
0 0 1 0 1 0 6 0 0 0 0
1 0 1 0 1 1 1 1 1 1 1
0 0 0 0 1 0 6 0 0 0 0
1 1 1 0 1 1 1 0 1 1 1
0 0 1 0 6 0 0 0 0 0 0
1 0 1 0 1 0 1 1 1 1 1
1 0 0 0 1 0 6 6 4 0 1
1 0 1 1 1 0 1 0 1 0 1
1 0 0 0 0 0 0 0 1 3 1
1 1 1 1 1 1 1 1 1 1 1
